F 139,99,58
C 171,154,50

NO textures/simonkraft/bookshelf.xpm    
SO textures/simonkraft/bookshelf_01.xpm
WE textures/simonkraft/bookshelf_02.xpm
EA textures/simonkraft/bookshelf_03.xpm

111111111111111111111
1001001001001001001
1001001N01001001001
1001001001001001001
1001001000001001001
1000000000000000001
1000011111111000001
1111000000000001111
1000000101010000001
1111111111111111111
