   WE                            textures/wall2.xpm
NO      textures/wall2.xpm



SO textures/wall2.xpm

F      88,0,0

EA textures/wall2.xpm



C 0,0,0

1111111111111111111111111
1000110000100000000000001
1000110000000000111111001
100011S000X00000110001001
1000P00000100000000001001
1111111111111111111111111
