NO textures/test/north.xpm
SO textures/test/south.xpm
WE textures/test/west.xpm
EA textures/test/east.xpm

F 20,20,20
C 200,200,200

11111
10001
10S01
10001
10001
10001
110011111111
1000100101001111111
10000000000000000001
10000000000000000001
1000111111111111X1
10001
10001
10001
11111
